 order_count_bucket | num_customers 
--------------------+---------------
 0                  |         15002
 1                  |             9
 10                 |          1993
 10+                |         20884
 2                  |            31
 3                  |           113
 4                  |           307
 5                  |           566
 6                  |           979
 7                  |          1410
 8                  |          1761
 9                  |          1945
(12 rows)

